                                                                                       
                                                                              ` `      
                                                                          ``````...`   
                                                                                       
                                                                                       
                                                                                       
                                                                                       
                       ``     ``.,,                `                                   
                ``,,.,:,`.,,,,,,,,,,,      ``,:`    ...       .:`                      
            ..,:`:`:`.`  ``::,,,,,:,.                  :,     `.::,.     ,.            
   ```     .,:,,``.`:,,,`   .,:,:,,:`         `` `   :`  :,:,,,,,,,:,::``.::``     .   
` `:,,:,:,:,.::,:::,:, `.:, ::,,:`          :,:,,,,,:,:,,,,:,,,::::,,,,:,,:,,:,:,,,:.` 
  :::,::,:,:::.:::,   `:`    `:        `  :,:`:,,,,,,,,,,,,:::,,:,,::,::::,::::,:,     
   ,     `:::,,:::::,``,:::             ,  ,. :::::::::::::::,:,,:,::::,,`   :: `      
           ,,::::::::,:::.`:`           `:,,,:,::::,,::::::,:::::::,:::::::  `         
            ::::::::`,,:`` ``          :::```::.```: ::,:::::::::::::::,` ,            
            .::::::::::               ```:::    `,:::::::::::::::::,: ,`,:             
           ` `::::`` `                :::::::::,,:,,`::,:,:::::::,:::`                 
    ,           ::``,  `,`         ` :::,:,:::::::,:::,   :::``,.,, ` `                
                    `` `,            ,:::::::::::::`.     `:    `:`  ,                 
                   `` `::::::        `     ,::::::::      `    :. `:`                  
                      ::::::::::,           ::::::               : ` .  .:: ,          
                       :::::::::            ::::::. ;`             `  `;; ,            
                        .::::::` `          :::::  :               `::::::::   .       
                        :::::                :::                   `:::::::::          
                      ``::::                                             `::      `    
                       `::`                                              `      ;      
                       ,:  `                                                           
                                                                                       
                                                                                   